11111111111111
1000C100000001
1000E00P000001
10000000001001
10000000001001
1C0000000010C1
11111111111111